rrr00000
00r00000
00rrr000
0000rrrc
00000000
00000000
00000000
00000000