........
.----...
.-......
.-......
.-......
.-p.....
.-......
.-p.....